WWWWWWWW0
W0000W00W
000000WW0
WW0W00WWW
WW0W00WW0
W00WW000W
WWWW00000
WWWWW000W
WWWWWWWW0
WWWWWWWWW
WWWWWWWW0
WWWWWWWWW
WWWWWWWW0
WWWWWWWWW
WWWWWWWW0
WWWWWWWWW
WWWWWWWW0
