WWWWWWWW0
W0W000WWW
00WWW0000
W0000WWWW
WWWW0W0W0
W00WW000W
WW00WW000
W00W00W0W
000000W00
W00W000WW
0W0WW0000
WWW00W0WW
00000WW00
WWW00000W
00WW0WW00
WW00WW0WW
WWWWWWWW0
