WWWWWWWW0
W000W000W
000000WW0
WW0W00WWW
WW0W00WW0
W00WW0W0W
WWWW00000
WWWWW0W0W
WWWWWWWW0
WWWWWWWWW
WWWWWWWW0
WWWWWWWWW
WWWWWWWW0
WWWWWWWWW
WWWWWWWW0
WWWWWWWWW
WWWWWWWW0
