WWWWWWWW0
W0W0W000W
00000WWW0
W00000WWW
W00000WW0
W00000W0W
000000W00
W00000WWW
W00000WW0
WW0000WWW
W00000WW0
WW0000WWW
WWWW0WWW0
WWWWWWWWW
WWWW0WWW0
WWWWWWWWW
WWWWWWWW0
